20
6
00010000000000000000
00010000000000000000
11111110000000000000
00000001000000000000
00000000111000111110
00000000000000000000
ooooooooooooxoooxooo
